30 30 30 30 30 30 30 30 30 30 30 30 30 30 57 07
30 03 04 05 04 06 05 06 60 59 06 04 07 30 30 19
30 33 20 20 20 20 20 20 20 20 20 20 19 30 30 19
30 33 20 20 20 20 20 20 20 20 20 20 57 04 59 61
30 19 20 20 20 20 20 20 20 20 20 20 20 20 20 20
30 33 20 20 20 20 20 20 20 20 20 20 20 20 20 20
30 48 20 20 20 20 20 20 20 20 20 20 03 06 59 07
30 19 20 20 20 20 20 20 20 20 20 20 19 30 30 19
30 57 59 59 60 77 59 06 60 04 07 20 19 30 03 61
30 30 30 30 30 30 30 30 30 30 19 20 23 30 33 20
30 03 58 04 04 59 04 06 07 30 44 20 23 30 33 20
30 19 20 20 20 20 20 20 57 06 61 20 23 30 57 07